"","Player","MP▼","FG","FGA","3P","3PA","2P","2PA","FT","FTA","ORB","DRB","TRB","AST","STL","BLK","TOV","PF","PTS"
"1","A.J. Hammons",163,17,42,5,10,12,32,9,20,8,28,36,4,1,13,10,21,48
"2","Aaron Brooks",1083,149,369,59,159,90,210,40,51,25,61,86,145,31,9,77,121,397
"3","Aaron Gordon",4542,845,1911,236,689,609,1222,342,478,216,815,1031,425,116,101,269,283,2268
"4","Aaron Holiday",646,105,262,43,127,62,135,41,50,5,62,67,87,21,13,40,71,294
"5","Abdel Nader",1216,141,364,55,165,86,199,50,75,27,160,187,46,35,22,60,113,387
"6","Al Horford",6443,1134,2277,256,671,878,1606,280,350,318,1135,1453,959,154,250,349,402,2804
"7","Al Jefferson",1415,346,679,0,4,346,675,95,121,105,316,421,87,35,39,54,191,787
"8","Al-Farouq Aminu",4364,487,1175,221,619,266,556,209,253,209,926,1135,188,147,73,151,279,1404
"9","Alan Williams",778,145,285,0,1,145,284,76,121,97,217,314,31,32,33,44,138,366
"10","Alec Burks",2434,362,888,108,310,254,578,223,265,49,378,427,195,76,29,125,166,1055
"11","Alex Abrines",2189,249,632,178,468,71,164,83,95,44,156,200,68,75,16,58,238,759
"12","Alex Caruso",1093,127,289,37,93,90,196,72,94,35,97,132,152,47,19,84,106,363
"13","Alex Len",2939,534,1026,75,207,459,819,298,447,333,609,942,168,54,130,175,358,1441
"14","Alex Poythress",409,51,107,13,34,38,73,18,29,36,57,93,19,7,11,15,63,133
"15","Alfonzo McKinnie",1056,142,290,45,127,97,163,29,51,82,172,254,32,19,16,33,142,358
"16","Allen Crabbe",5584,777,1847,433,1093,344,754,261,315,63,635,698,257,124,68,186,441,2248
"17","Allonzo Trier",1459,232,518,52,132,180,386,179,223,31,166,197,119,28,14,116,117,695
"18","Alonzo Gee",89,3,14,0,3,3,11,5,9,4,11,15,6,5,1,4,14,11
"19","Amile Jefferson",68,10,16,0,0,10,16,7,8,6,15,21,3,3,3,1,8,27
"20","Amir Johnson",3308,432,787,49,138,383,649,150,226,288,555,843,318,112,119,177,502,1063
"21","Anderson Varejao",92,5,14,0,0,5,14,8,11,12,15,27,10,3,3,8,16,18
"22","Andre Drummond",7681,1510,2844,7,56,1503,2788,619,1162,1167,2427,3594,439,374,354,527,759,3646
"23","Andre Iguodala",5198,518,1037,145,438,373,599,166,256,149,653,802,687,191,128,177,291,1347
"24","Andre Ingram",64,8,17,5,9,3,8,3,3,1,5,6,7,3,3,3,3,24
"25","Andre Roberson",3413,302,625,53,220,249,405,59,149,173,415,588,125,139,114,81,293,716
"26","Andrew Bogut",350,35,61,0,0,35,61,5,5,38,95,133,26,7,21,27,62,75
"27","Andrew Harrison",1513,197,482,52,167,145,315,141,177,29,122,151,201,42,28,93,172,587
"28","Andrew White",209,25,73,18,49,7,24,1,4,4,30,34,6,3,1,8,12,69
"29","Andrew Wiggins",8570,1776,4079,333,975,1443,3104,821,1152,267,771,1038,533,243,129,463,499,4706
"30","Anfernee Simons",141,28,63,10,29,18,34,9,16,3,10,13,13,1,0,11,9,75
"31","Ante Žižić",1296,232,398,0,0,232,398,114,161,132,248,380,58,15,35,72,143,578
"32","Anthony Brown",159,18,50,7,27,11,23,0,0,8,25,33,8,5,1,6,15,43
"33","Anthony Davis",7285,2080,4014,143,441,1937,3573,1358,1678,533,1855,2388,549,297,495,455,459,5661
"34","Anthony Morrow",714,98,252,41,133,57,119,34,37,12,19,31,25,24,2,6,44,271
"35","Anthony Tolliver",4313,473,1082,330,810,143,272,214,275,116,539,655,213,83,62,150,344,1490
"36","Antonio Blakeney",1143,219,539,51,143,168,396,80,115,11,128,139,62,19,10,46,60,569
"37","Archie Goodwin",214,36,66,5,15,31,51,33,42,7,21,28,24,4,5,14,8,110
"38","Aron Baynes",3469,458,948,24,82,434,866,191,234,329,678,1007,182,51,124,170,491,1131
"39","Arron Afflalo",2262,250,582,89,221,161,361,105,119,13,178,191,108,25,15,63,160,694
"40","Austin Rivers",4085,573,1377,240,687,333,690,152,254,52,255,307,409,121,39,177,359,1538
"41","Avery Bradley",3338,507,1233,161,448,346,785,106,132,65,226,291,246,92,24,190,259,1281
"42","Bam Adebayo",1913,280,486,3,15,277,471,166,226,165,432,597,184,71,65,121,203,729
"43","Ben McLemore",2425,362,856,137,370,225,486,131,169,56,229,285,106,73,24,128,269,992
"44","Ben Simmons",5432,1084,1958,0,17,1084,1941,448,769,317,1039,1356,1271,252,131,552,420,2616
"45","Billy Garrett",63,11,27,0,8,11,19,4,4,0,3,3,7,1,1,2,3,26
"46","Bismack Biyombo",4071,451,847,0,1,451,846,285,482,382,900,1282,173,57,227,213,463,1187
"47","Blake Griffin",6668,1534,3308,338,957,1196,2351,993,1301,285,1205,1490,1036,150,68,560,495,4399
"48","Boban Marjanovic",1311,311,540,4,10,307,530,222,286,181,358,539,85,32,50,105,166,848
"49","Bobby Brown",238,42,118,25,75,17,43,3,4,0,13,13,25,5,0,14,11,112
"50","Bobby Portis",2942,661,1439,155,414,506,1025,197,253,268,633,901,195,85,43,177,275,1674
"51","Bogdan Bogdanović",1947,361,863,134,372,227,491,134,162,40,203,243,267,72,15,117,142,990
"52","Bojan Bogdanovic",7120,1302,2748,463,1164,839,1584,641,753,100,780,880,391,158,16,371,413,3708
"53","Bonzie Colson",98,13,39,5,21,8,18,8,9,8,22,30,3,5,1,3,3,39
"54","Boris Diaw",1283,146,327,20,81,126,246,26,35,46,112,158,170,18,9,87,83,338
"55","Brad Wanamaker",343,50,105,16,39,34,66,24,28,3,38,41,56,12,2,19,34,140
"56","Bradley Beal",8689,2084,4415,631,1678,1453,2737,936,1159,203,811,1014,1088,300,115,594,555,5735
"57","Brandan Wright",828,142,237,0,1,142,236,44,68,64,109,173,28,24,46,18,74,328
"58","Brandon Goodwin",57,6,23,2,6,4,17,9,11,1,2,3,14,0,0,3,7,23
"59","Brandon Ingram",6014,996,2176,127,386,869,1790,520,785,158,739,897,550,123,110,394,470,2639
"60","Brandon Jennings",2007,219,607,88,285,131,322,124,162,34,193,227,439,76,8,146,127,650
"61","Brandon Knight",736,99,260,41,129,58,131,27,34,10,49,59,71,21,2,30,62,266
"62","Brandon Paul",576,55,127,15,54,40,73,22,43,6,62,68,37,25,7,29,58,147
"63","Brandon Rush",1030,70,187,44,114,26,73,13,18,16,83,99,45,22,23,28,42,197
"64","Brandon Sampson",214,28,60,11,29,17,31,4,6,3,13,16,10,8,3,12,19,71
"65","Brian Roberts",416,46,122,17,44,29,78,33,39,5,34,39,52,9,1,26,18,142
"66","Briante Weber",442,44,103,5,21,39,82,19,26,16,45,61,43,30,6,23,44,112
"67","Brook Lopez",6279,1279,2751,433,1224,846,1527,518,655,228,865,1093,400,119,401,364,576,3509
"68","Bruce Brown",1449,125,314,24,93,101,221,45,60,48,137,185,91,40,36,46,178,319
"69","Bruno Caboclo",907,105,256,51,147,54,109,47,56,49,131,180,54,17,37,42,89,308
"70","Bryn Forbes",3810,570,1288,265,641,305,647,117,150,30,319,349,255,73,6,117,267,1522
"71","Buddy Hield",4639,1039,2293,454,1059,585,1234,242,274,161,558,719,360,143,55,270,350,2774
"72","C.J. Miles",2193,339,910,231,657,108,253,129,155,31,216,247,91,63,36,69,213,1038
"73","C.J. Wilcox",108,8,31,3,15,5,16,2,2,4,8,12,12,2,1,6,8,21
"74","C.J. Williams",835,104,232,27,94,77,138,13,17,13,51,64,55,37,13,25,79,248
"75","Caleb Swanigan",178,18,53,1,7,17,46,6,9,17,47,64,11,6,1,18,28,43
"76","Cameron Payne",1756,247,631,87,261,160,370,50,65,34,155,189,274,68,22,110,160,631
"77","Cameron Reynolds",259,33,78,21,51,12,27,8,9,4,27,31,13,6,2,5,26,95
"78","Caris LeVert",4164,698,1598,192,583,506,1015,285,403,111,488,599,565,173,44,281,327,1873
"79","Carmelo Anthony",5333,1123,2678,341,959,782,1719,467,580,138,807,945,321,111,90,260,427,3054
"80","Cedi Osman",3116,450,1030,162,461,288,569,167,227,64,413,477,236,82,14,146,273,1229
"81","Chandler Parsons",1862,251,638,105,308,146,330,74,95,24,220,244,167,57,21,91,150,681
"82","Channing Frye",2434,385,849,208,529,177,320,91,107,53,424,477,103,57,55,87,251,1069
"83","Chasson Randle",1042,131,315,62,162,69,153,84,105,16,72,88,131,34,5,62,130,408
"84","Cheick Diallo",1477,270,447,1,4,269,443,100,133,122,421,543,52,40,54,77,195,641
"85","Chinanu Onuaku",52,5,7,0,0,5,7,4,4,2,8,10,3,3,1,4,6,14
"86","Chris Andersen",114,9,22,0,3,9,19,10,14,9,22,31,5,5,7,5,20,28
"87","Chris Boucher",163,34,76,12,37,22,39,13,15,16,40,56,2,6,24,7,31,93
"88","Chris McCullough",170,34,74,2,15,32,59,12,19,16,28,44,6,2,7,5,15,82
"89","Chris Paul",3704,669,1518,271,734,398,784,378,424,73,505,578,930,210,32,280,287,1987
"90","Christian Wood",251,61,117,9,26,52,91,41,56,17,66,83,8,7,10,17,17,172
"91","CJ McCollum",8094,1930,4189,541,1360,1389,2829,636,736,175,717,892,764,204,105,429,542,5037
"92","Clint Capela",5834,1277,1971,0,1,1277,1970,404,695,717,1459,2176,227,136,318,284,532,2958
"93","Cody Zeller",3595,528,944,8,26,520,918,305,422,312,603,915,232,114,120,160,434,1369
"94","Cole Aldrich",531,45,86,0,0,45,86,15,22,51,107,158,25,25,23,17,85,105
"95","Collin Sexton",2605,519,1206,119,296,400,910,214,255,57,179,236,243,44,6,185,186,1371
"96","Corey Brewer",2981,342,787,72,272,270,515,146,201,101,295,396,201,172,41,123,335,902
"97","Cory Joseph",6276,781,1813,170,496,611,1317,194,259,129,648,777,846,240,53,275,412,1926
"98","Courtney Lee",5197,717,1588,237,602,480,986,213,243,92,445,537,396,182,44,167,282,1884
"99","Cristiano Felicio",2017,255,436,0,2,255,434,114,174,207,337,544,95,41,28,87,214,624
"100","D.J. Augustin",5567,757,1734,340,857,417,877,476,559,86,394,480,922,137,5,341,310,2330
"101","D.J. Wilson",953,113,267,48,132,65,135,27,49,47,185,232,55,21,21,36,92,301
"102","D'Angelo Russell",3682,937,2189,324,913,613,1276,257,336,83,421,504,812,136,37,400,234,2455
"103","Dakari Johnson",161,22,39,0,0,22,39,11,20,16,18,34,8,6,8,3,27,55
"104","Damian Jones",584,72,112,0,0,72,112,30,52,45,67,112,30,14,32,26,92,174
"105","Damian Lillard",8202,1963,4436,678,1851,1285,2585,1449,1596,176,888,1064,1472,233,81,615,417,6053
"106","Damien Wilkins",152,13,39,4,18,9,21,3,4,5,11,16,9,2,1,5,7,33
"107","Damion Lee",779,118,279,42,128,76,151,41,51,19,116,135,42,32,1,25,53,319
"108","Damyean Dotson",2478,362,859,148,410,214,449,89,121,43,303,346,166,70,12,88,169,961
"109","Daniel Ochefu",75,12,27,0,0,12,27,0,2,5,17,22,3,2,0,3,17,24
"110","Daniel Theis",1844,272,499,44,125,228,374,117,157,177,322,499,124,51,90,89,318,705
"111","Danilo Gallinari",2730,511,1140,197,483,314,657,448,493,63,455,518,219,61,33,125,159,1667
"112","Danny Green",4007,510,1191,314,755,196,436,87,109,101,465,566,236,136,133,149,293,1421
"113","Dante Cunningham",2490,239,522,88,233,151,289,45,70,126,360,486,98,66,43,55,182,611
"114","Dante Exum",899,143,328,23,80,120,248,93,117,20,74,94,153,22,8,72,89,402
"115","Danuel House",979,118,252,74,178,44,74,56,71,25,115,140,40,21,11,35,80,366
"116","Dario Saric",6462,1088,2513,381,1063,707,1450,482,577,392,1098,1490,511,153,59,428,504,3039
"117","Darius Miller",3701,405,971,280,722,125,249,114,138,32,260,292,257,68,40,117,325,1204
"118","Darrell Arthur",141,22,47,8,23,14,24,2,3,3,12,15,9,8,3,15,22,54
"119","Darren Collison",6224,964,2011,248,574,716,1437,432,505,96,466,562,1139,269,33,325,379,2608
"120","Darrun Hilliard",476,52,145,12,52,40,93,27,35,2,38,40,44,13,2,32,46,143
"121","David Lee",1477,248,420,0,0,248,420,80,113,149,292,441,124,31,40,82,125,576
"122","David Nwaba",3027,375,766,43,132,332,634,216,327,147,405,552,172,108,53,117,300,1009
"123","David West",1853,351,630,6,16,345,614,103,135,111,330,441,289,89,123,158,225,811
"124","Davis Bertans",2718,365,819,239,590,126,229,93,109,41,376,417,174,61,61,79,226,1062
"125","De'Aaron Fox",4572,833,1899,133,385,700,1514,444,612,76,432,508,910,203,65,400,367,2243
"126","Deandre Ayton",2183,509,870,0,4,509,866,141,189,223,506,729,125,61,67,126,209,1159
"127","DeAndre Jordan",7041,1071,1601,0,2,1071,1599,572,1001,852,2335,3187,369,132,278,405,582,2714
"128","DeAndre Liggins",1501,95,248,36,99,59,149,27,45,27,156,183,102,84,28,62,162,253
"129","DeAndre' Bembry",2386,328,744,61,203,267,541,106,169,62,368,430,251,126,53,189,228,823
"130","Dejounte Murray",1743,270,609,9,34,261,575,105,148,110,349,459,231,97,31,134,151,654
"131","Delon Wright",3578,492,1106,116,351,376,755,258,322,129,383,512,505,187,74,180,215,1358
"132","DeMar DeRozan",8019,1997,4271,129,456,1868,3815,1372,1647,183,980,1163,1182,249,71,554,462,5495
"133","DeMarcus Cousins",4973,1231,2667,261,752,970,1915,917,1208,300,1358,1658,696,219,213,583,570,3640
"134","DeMarre Carroll",5765,772,1910,360,1021,412,889,461,605,236,867,1103,306,171,67,230,422,2365
"135","Demetrius Jackson",80,7,18,1,7,6,11,1,2,5,7,12,9,5,1,10,7,16
"136","Deng Adel",194,11,36,6,23,5,13,4,4,3,16,19,5,1,4,6,13,32
"137","Dennis Schroder",4563,1048,2360,176,556,872,1804,443,520,86,370,456,916,146,22,441,296,2715
"138","Dennis Smith",3557,682,1674,173,547,509,1127,233,349,82,333,415,610,138,38,348,281,1770
"139","Denzel Valentine",2095,301,721,143,370,158,351,38,51,48,345,393,244,65,11,99,185,783
"140","Deonte Burton",240,33,82,8,27,25,55,8,12,4,24,28,9,6,8,9,31,82
"141","Deron Williams",1657,263,600,85,234,178,366,90,109,14,133,147,360,31,8,138,138,701
"142","Derrick Favors",5105,961,1738,34,151,927,1587,361,552,497,920,1417,247,155,228,232,430,2317
"143","Derrick Jones",1943,249,498,34,120,215,378,119,187,156,201,357,58,64,68,63,210,651
"144","Derrick Rose",3894,904,1916,74,236,830,1680,398,459,112,309,421,540,82,33,264,157,2280
"145","Derrick Walton",147,8,25,7,17,1,8,6,6,2,14,16,16,7,3,2,7,29
"146","Derrick White",1867,276,576,56,155,220,421,109,143,40,233,273,272,71,50,103,153,717
"147","Devin Booker",6837,1647,3740,429,1203,1218,2537,1049,1224,111,647,758,954,175,48,699,610,4772
"148","Devin Harris",3498,455,1142,199,604,256,538,351,433,35,331,366,410,125,35,189,392,1460
"149","Devin Robinson",95,19,32,0,2,19,30,9,14,6,14,20,6,4,6,2,11,47
"150","Devonte' Graham",676,74,216,34,121,40,95,35,46,10,53,63,121,23,2,30,48,217
"151","Dewayne Dedmon",4481,670,1262,133,358,537,904,224,292,334,1131,1465,224,146,183,231,556,1697
"152","Deyonta Davis",1299,200,334,0,1,200,333,54,85,105,241,346,47,21,61,43,177,454
"153","Dillon Brooks",2680,389,894,109,304,280,590,146,196,58,230,288,151,83,21,143,283,1033
"154","Dion Waiters",2056,361,888,161,459,200,429,73,113,15,178,193,234,52,18,134,133,956
"155","Dirk Nowitzki",2695,481,1134,202,542,279,592,136,158,27,569,596,155,52,63,69,222,1300
"156","Domantas Sabonis",3648,753,1361,22,54,731,1307,376,515,351,911,1262,363,88,62,297,459,1904
"157","Donovan Mitchell",5236,1256,2892,375,1069,881,1823,558,693,111,501,612,613,224,58,433,421,3445
"158","Dorian Finney-Smith",4075,398,982,155,512,243,470,130,179,215,471,686,188,131,65,140,354,1081
"159","Doug McDermott",4616,666,1427,253,630,413,797,201,244,77,411,488,204,50,29,136,305,1786
"160","Dragan Bender",3469,332,842,168,524,164,318,75,116,97,550,647,209,50,97,181,330,907
"161","Draymond Green",6823,741,1691,205,684,536,1007,348,477,233,1382,1615,1495,344,267,555,599,2035
"162","Drew Eubanks",113,15,26,0,0,15,26,11,13,6,28,34,7,2,5,8,11,41
"163","Duncan Robinson",161,18,46,10,35,8,11,4,6,2,17,19,5,5,0,4,11,50
"164","Dwayne Bacon",1472,194,449,49,130,145,319,54,71,12,201,213,85,28,7,41,118,491
"165","Dwight Howard",4892,937,1593,1,9,936,1584,589,1054,575,1460,2035,213,119,227,394,486,2464
"166","Dwight Powell",4667,739,1293,88,285,651,1008,436,580,368,793,1161,252,172,121,160,522,2002
"167","Dwyane Wade",5213,1129,2597,163,517,966,2080,523,703,182,625,807,757,206,126,444,354,2944
"168","E'Twaun Moore",5869,962,1983,281,685,681,1298,150,201,125,392,517,453,169,52,223,425,2355
"169","Ed Davis",3706,431,736,0,3,431,733,224,354,495,1018,1513,127,82,107,167,551,1086
"170","Edmond Sumner",210,22,64,7,27,15,37,15,24,9,15,24,10,12,5,10,26,66
"171","Ekpe Udoh",1130,110,192,0,1,110,191,61,86,95,145,240,81,53,105,33,141,281
"172","Elfrid Payton",3058,508,1079,63,197,445,882,164,242,113,381,494,713,127,39,280,228,1243
"173","Emeka Okafor",353,48,95,0,0,48,95,18,22,47,73,120,8,8,25,13,30,114
"174","Emmanuel Mudiay",4258,742,1817,172,536,570,1281,373,482,88,438,526,651,125,43,376,278,2029
"175","Enes Kanter",5003,1199,2133,15,74,1184,2059,535,666,725,1196,1921,288,100,101,363,508,2948
"176","Eric Bledsoe",6770,1387,2994,353,1047,1034,1947,817,1011,185,781,966,1218,356,102,605,505,3944
"177","Eric Gordon",6635,1211,2924,680,1869,531,1055,461,568,71,448,519,471,133,95,341,409,3563
"178","Eric Moreland",805,66,122,0,0,66,122,11,29,81,197,278,78,31,51,42,116,143
"179","Ersan Ilyasova",3871,661,1503,233,655,428,848,266,342,233,653,886,231,119,49,188,368,1821
"180","Evan Fournier",6624,1244,2801,408,1145,836,1656,510,620,105,542,647,662,184,32,390,543,3406
"181","Evan Turner",5297,697,1572,84,302,613,1270,251,316,103,716,819,661,133,71,313,394,1729
"182","Frank Jackson",1169,194,447,53,169,141,278,54,73,25,109,134,69,25,2,48,92,495
"183","Frank Kaminsky",4544,765,1816,270,767,495,1049,352,457,142,645,787,354,94,65,183,302,2152
"184","Frank Mason",1419,215,549,45,150,170,399,133,172,36,137,173,231,50,14,101,106,608
"185","Frank Ntilikina",904,95,282,33,115,62,167,23,30,12,75,87,121,30,14,56,104,246
"186","Fred VanVleet",3574,517,1256,231,586,286,670,199,238,50,343,393,585,141,42,171,276,1464
"187","Furkan Korkmaz",759,106,273,52,161,54,112,38,48,18,100,118,56,31,3,27,74,302
"188","Garrett Temple",3655,407,969,179,491,228,478,140,185,50,318,368,230,133,57,149,339,1133
"189","Gary Harris",5725,1030,2182,345,891,685,1291,353,440,126,388,514,485,248,42,263,324,2758
"190","Gary Payton",320,38,96,7,34,31,62,6,14,13,43,56,34,10,7,17,39,89
"191","George Hill",4658,695,1495,227,591,468,904,337,421,104,392,496,525,163,46,224,344,1954
"192","Georges Niang",609,95,217,44,117,51,100,22,26,13,91,104,40,13,6,28,63,256
"193","Georgios Papagiannis",122,18,42,0,0,18,42,0,0,13,24,37,9,4,6,8,12,36
"194","Gerald Green",2940,494,1223,305,850,189,373,141,169,61,338,399,98,66,49,111,261,1434
"195","Gerald Henderson",1667,234,553,61,173,173,380,133,165,34,151,185,112,40,15,62,129,662
"196","Gian Clavell",64,6,18,6,15,0,3,2,2,1,6,7,3,2,0,2,8,20
"197","Giannis Antetokounmpo",7959,2119,3908,144,523,1975,3385,1458,1939,457,1894,2351,1219,332,367,725,709,5840
"198","Glenn Robinson",2375,268,599,81,221,187,378,95,127,85,269,354,85,68,29,60,122,712
"199","Goran Dragic",4837,1018,2199,228,589,790,1610,515,648,116,470,586,782,152,25,378,379,2779
"200","Gordon Hayward",4379,841,1791,226,605,615,1186,518,616,100,616,716,496,135,43,245,221,2426
"201","Gorgui Dieng",2364,375,765,38,117,337,648,167,208,187,484,671,143,93,80,116,281,955
"202","Greg Monroe",3343,697,1301,1,9,696,1292,310,430,343,711,1054,325,150,69,266,329,1705
"203","Guerschon Yabusele",486,61,138,21,65,40,73,30,44,40,65,105,31,12,12,27,55,173
"204","Harrison Barnes",7970,1567,3515,371,996,1196,2519,730,872,227,996,1223,383,164,42,318,344,4235
"205","Harry Giles",820,175,348,0,6,175,342,58,91,66,156,222,85,31,22,73,150,408
"206","Hassan Whiteside",5551,1242,2231,4,18,1238,2213,462,783,724,1799,2523,167,140,391,343,549,2950
"207","Henry Ellenson",734,115,305,47,133,68,172,48,62,23,165,188,43,13,3,41,55,325
"208","Hollis Thompson",752,77,200,32,95,45,105,19,29,19,93,112,35,20,6,11,69,205
"209","Ian Clark",3565,584,1311,189,560,395,751,122,154,45,292,337,294,94,26,170,292,1479
"210","Ian Mahinmi",2198,250,463,3,18,247,445,175,264,230,360,590,97,96,82,155,404,678
"211","Iman Shumpert",3694,390,993,196,560,194,433,118,150,73,369,442,238,130,55,144,299,1094
"212","Isaac Bonga",120,5,33,0,8,5,25,9,15,9,16,25,15,9,4,6,9,19
"213","Isaac Humphries",56,6,21,3,11,3,10,0,0,4,7,11,0,1,0,0,7,15
"214","Isaiah Briscoe",559,55,138,11,34,44,104,15,26,5,69,74,87,11,2,31,66,136
"215","Isaiah Canaan",1643,179,474,81,256,98,218,95,108,18,135,153,197,52,4,85,123,534
"216","Isaiah Hartenstein",221,20,41,2,6,18,35,11,14,21,26,47,15,7,12,13,56,53
"217","Isaiah Hicks",240,33,72,2,9,31,63,12,18,10,31,41,16,2,4,16,45,80
"218","Isaiah Taylor",1219,164,397,20,82,144,315,100,143,23,74,97,209,35,11,84,122,448
"219","Isaiah Thomas",1043,191,520,67,231,124,289,134,158,22,58,80,176,20,4,113,75,583
"220","Isaiah Whitehead",180,40,86,7,18,33,68,13,19,4,22,26,20,8,2,24,23,100
"221","Ish Smith",5249,923,2039,107,341,816,1698,200,280,71,533,604,981,153,64,281,376,2153
"222","Ivan Rabb",1237,202,364,3,15,199,349,78,105,123,241,364,86,29,27,70,145,485
"223","Ivica Zubac",1450,273,501,0,1,273,500,140,177,160,325,485,88,22,66,96,184,686
"224","J.J. Barea",2355,464,1075,153,441,311,634,135,180,28,268,296,645,57,4,215,133,1216
"225","J.J. Redick",4495,856,1906,433,1065,423,841,425,473,29,335,364,416,67,23,204,252,2570
"226","J.R. Smith",2466,267,674,155,420,112,254,47,66,29,224,253,162,79,14,92,180,736
"227","Jabari Parker",4195,928,1895,157,454,771,1441,333,456,200,686,886,353,121,62,289,306,2346
"228","Jack Cooley",87,13,27,0,0,13,27,14,19,14,16,30,6,1,0,3,13,40
"229","Jacob Evans",204,18,53,4,15,14,38,0,1,6,19,25,23,5,3,11,28,40
"230","Jae Crowder",6591,922,2188,440,1257,482,931,439,562,167,907,1074,387,201,75,239,518,2723
"231","Jahlil Okafor",2422,531,971,2,9,529,962,186,276,184,419,603,110,38,107,164,269,1250
"232","JaKarr Sampson",471,73,135,10,24,63,111,27,37,26,84,110,13,12,25,12,56,183
"233","Jake Layman",1487,230,471,63,201,167,270,52,74,60,173,233,64,37,34,51,129,575
"234","Jakob Pöltl",2797,440,674,1,2,439,672,109,193,343,460,803,150,68,168,133,336,990
"235","Jalen Jones",395,52,130,20,54,32,76,31,46,24,48,72,11,14,3,15,49,155
"236","Jamal Crawford",2864,482,1180,171,516,311,664,195,223,29,155,184,414,73,21,194,160,1330
"237","Jamal Murray",5012,992,2235,317,850,675,1385,418,476,147,467,614,637,146,55,330,326,2719
"238","Jameer Nelson",1013,95,244,41,124,54,120,16,20,13,91,104,179,27,4,67,81,247
"239","Jamel Artis",279,31,79,8,29,23,50,7,12,4,34,38,18,2,3,8,11,77
"240","James Ennis",4335,466,999,157,446,309,553,241,307,202,463,665,176,134,60,149,449,1330
"241","James Harden",8365,2168,4891,905,2506,1263,2385,2124,2466,202,1364,1566,2123,405,146,1166,628,7365
"242","James Johnson",5192,841,1762,194,590,647,1172,315,447,149,761,910,691,181,164,386,503,2191
"243","James Jones",381,44,92,31,66,13,26,13,20,3,34,37,14,6,10,10,37,132
"244","James Michael McAdoo",457,62,117,2,8,60,109,21,42,34,57,91,18,18,29,19,47,147
"245","James Nunnally",102,12,34,8,25,4,9,4,4,0,5,5,7,1,0,1,10,36
"246","James Webb",120,6,24,4,19,2,5,0,0,8,16,24,4,1,0,4,10,16
"247","James Young",281,30,72,15,45,15,27,10,15,6,22,28,6,10,2,5,19,85
"248","JaMychal Green",5014,703,1464,169,448,534,1016,294,379,418,999,1417,213,124,93,257,594,1869
"249","Jared Dudley",3268,306,707,159,434,147,273,102,146,73,401,474,282,102,43,144,370,873
"250","Jared Sullinger",118,15,47,3,18,12,29,4,8,10,17,27,3,4,1,4,17,37
"251","Jared Terrell",111,12,39,4,17,8,22,3,6,1,5,6,12,3,2,10,16,31
"252","Jarell Eddie",62,6,19,4,16,2,3,8,9,1,6,7,0,1,0,1,1,24
"253","Jarell Martin",2547,322,751,63,180,259,571,138,177,150,403,553,99,59,66,125,353,845
"254","Jaren Jackson",1515,298,589,51,142,247,447,151,197,73,199,272,64,52,82,98,220,798
"255","Jaron Blossomgame",439,47,106,10,39,37,67,10,13,26,72,98,13,7,8,11,20,114
"256","Jarred Vanderbilt",69,9,19,0,1,9,18,6,10,7,16,23,3,6,1,8,8,24
"257","Jarrett Allen",3537,569,965,11,60,558,905,311,425,335,725,1060,159,71,208,185,331,1460
"258","Jarrod Uthoff",115,16,38,3,9,13,29,5,7,8,14,22,9,2,4,3,8,40
"259","Jason Smith",1543,240,503,50,136,190,367,68,88,98,265,363,65,27,74,87,242,598
"260","Jason Terry",2179,164,397,113,286,51,111,32,38,20,134,154,157,88,33,61,147,473
"261","JaVale McGee",2286,536,860,1,18,535,842,134,204,254,481,735,85,68,205,135,299,1207
"262","Jawun Evans",65,3,14,0,3,3,11,0,0,1,11,12,10,3,0,6,8,6
"263","Jaylen Adams",428,38,110,25,74,13,36,7,9,11,49,60,65,14,5,28,45,108
"264","Jaylen Brown",5406,933,2018,262,717,671,1301,368,559,176,703,879,278,174,76,291,509,2496
"265","Jaylen Morris",98,13,32,2,10,11,22,0,0,2,14,16,7,2,1,6,2,28
"266","Jayson Tatum",4893,863,1871,221,553,642,1318,408,486,120,759,879,296,167,115,236,338,2355
"267","Jeff Green",3925,621,1305,164,490,457,815,386,440,117,438,555,236,84,73,176,309,1792
"268","Jeff Teague",3575,530,1210,119,333,411,877,325,392,40,275,315,835,145,41,274,261,1504
"269","Jemerrio Jones",143,12,33,2,10,10,23,1,2,16,33,49,13,7,5,5,10,27
"270","Jerami Grant",5790,805,1607,190,519,615,1088,409,608,220,721,941,182,125,256,165,518,2209
"271","Jeremy Lamb",5360,1037,2302,250,730,787,1572,520,597,144,878,1022,433,176,87,213,376,2844
"272","Jeremy Lin",2319,413,941,113,343,300,598,291,351,33,281,314,415,89,27,210,223,1230
"273","Jerian Grant",2625,301,723,101,297,200,426,166,228,50,220,270,498,107,14,140,210,869
"274","Jerryd Bayless",1653,202,524,85,249,117,275,60,82,29,125,154,186,41,8,87,151,549
"275","Jevon Carter",577,56,185,34,102,22,83,26,32,14,52,66,69,26,11,33,55,172
"276","Jimmer Fredette",65,8,29,0,13,8,16,6,6,1,6,7,8,3,0,5,5,22
"277","Jimmy Butler",7158,1425,3077,228,641,1197,2436,1260,1466,329,797,1126,968,382,95,362,301,4338
"278","Joakim Noah",1708,209,415,0,2,209,413,112,187,220,421,641,192,50,68,108,223,530
"279","Jodie Meeks",1223,178,432,80,228,98,204,102,118,16,122,138,78,30,5,39,60,538
"280","Joe Harris",4268,679,1369,333,744,346,625,196,237,103,448,551,309,73,37,212,335,1887
"281","Joe Ingles",5146,694,1520,393,947,301,573,153,206,59,615,674,861,188,40,352,358,1934
"282","Joe Johnson",1205,146,360,40,145,106,215,40,45,14,158,172,83,18,7,49,67,372
"283","Joe Young",693,106,258,30,89,76,169,33,44,13,67,80,54,18,1,31,44,275
"284","Joel Bolomboy",53,9,16,1,4,8,12,3,6,4,13,17,2,1,2,2,1,22
"285","Joel Embiid",4852,1290,2684,181,575,1109,2109,1072,1360,364,1440,1804,499,113,309,577,532,3833
"286","Joffrey Lauvergne",1514,246,526,33,103,213,423,76,120,135,287,422,111,34,9,89,128,601
"287","John Collins",1829,465,831,55,158,410,673,203,266,219,376,595,121,22,39,120,199,1188
"288","John Henson",3281,477,878,12,39,465,839,170,275,258,621,879,185,81,198,148,369,1136
"289","John Holland",174,17,59,11,36,6,23,9,13,6,18,24,5,7,2,8,10,54
"290","John Jenkins",333,42,105,22,58,20,47,15,18,6,31,37,22,0,2,9,10,121
"291","John Wall",5350,1172,2654,202,608,970,2046,719,943,96,496,592,1503,263,123,601,302,3265
"292","Johnathan Motley",332,79,148,1,9,78,139,39,68,32,68,100,18,8,5,25,45,198
"293","Johnny O'Bryant",459,83,201,17,49,66,152,26,31,38,74,112,20,9,7,21,55,209
"294","Jon Leuer",538,81,149,1,14,80,135,36,46,34,95,129,19,13,7,30,76,199
"295","Jonas Jerebko",3584,436,958,179,475,257,483,136,174,184,622,806,209,76,47,109,386,1187
"296","Jonas Valanciunas",3793,781,1389,31,76,750,1313,346,428,409,1010,1419,138,66,132,221,408,1939
"297","Jonathan Gibson",231,35,95,15,45,20,50,21,29,1,21,22,26,8,0,21,21,106
"298","Jonathan Isaac",2532,317,756,102,312,215,444,129,160,115,395,510,98,92,128,102,191,865
"299","Jonathon Simmons",3093,487,1111,97,308,390,803,257,338,88,277,365,299,87,31,214,264,1328
"300","Jordan Bell",788,99,192,0,2,99,190,25,41,55,129,184,76,20,51,42,80,223
"301","Jordan Clarkson",6499,1436,3205,373,1119,1063,2086,448,550,188,545,733,630,203,27,426,369,3693
"302","Jordan Crawford",495,117,245,45,109,72,136,21,27,6,32,38,70,12,3,30,37,300
"303","Jordan McRae",717,119,280,28,86,91,194,55,69,12,69,81,49,21,13,29,57,321
"304","Jordan Mickey",284,39,82,2,16,37,66,13,19,18,63,81,9,6,10,18,36,93
"305","Jose Calderon",1453,148,319,65,161,83,158,35,42,29,129,158,205,38,3,82,117,396
"306","Josh Gray",86,11,41,3,13,8,28,7,11,2,8,10,12,8,2,7,8,32
"307","Josh Hart",3176,365,839,170,471,195,368,121,174,77,434,511,173,111,56,105,254,1021
"308","Josh Jackson",3947,736,1773,130,442,606,1331,320,492,161,537,698,302,154,91,319,427,1922
"309","Josh McRoberts",381,44,118,13,31,31,87,6,9,23,51,74,50,10,4,23,31,107
"310","Josh Okogie",1757,196,508,60,215,136,293,118,162,41,177,218,91,88,33,63,166,570
"311","Josh Richardson",6842,1024,2424,366,1023,658,1401,379,450,158,558,716,669,260,148,318,531,2793
"312","Jrue Holiday",7519,1567,3296,338,1000,1229,2296,514,677,183,780,963,1492,332,162,617,482,3986
"313","Juan Hernangomez",1119,130,299,60,163,70,136,67,88,61,180,241,41,36,15,40,87,387
"314","Julian Washburn",254,16,48,5,24,11,24,3,4,8,33,41,14,13,2,7,16,40
"315","Julius Randle",6554,1452,2766,94,303,1358,2463,865,1194,493,1431,1924,703,144,127,594,768,3863
"316","Julyan Stone",175,6,13,6,13,0,0,1,2,1,28,29,26,4,2,7,21,19
"317","Justin Anderson",2210,337,798,116,374,221,424,156,202,118,304,422,114,78,43,105,211,946
"318","Justin Hamilton",1177,174,379,55,180,119,199,39,52,71,191,262,55,29,43,43,91,442
"319","Justin Holiday",6511,823,2097,420,1187,403,910,296,350,104,735,839,401,266,98,263,407,2362
"320","Justin Jackson",3120,402,904,144,430,258,474,88,115,71,328,399,170,60,27,69,180,1036
"321","Justise Winslow",3639,531,1237,145,385,386,852,152,241,127,598,725,430,126,52,219,317,1359
"322","Jusuf Nurkic",4062,900,1777,3,36,897,1741,454,638,432,1024,1456,376,135,214,351,497,2257
"323","Kadeem Allen",523,71,163,17,47,54,116,49,63,12,50,62,88,19,6,35,61,208
"324","Karl-Anthony Towns",5463,1320,2486,262,640,1058,1846,721,852,501,1465,1966,458,131,240,399,577,3623
"325","Kawhi Leonard",2250,612,1240,123,337,489,903,395,464,84,397,481,220,124,33,137,96,1742
"326","Kay Felder",140,21,70,4,19,17,51,11,12,3,15,18,20,3,1,16,11,57
"327","Keita Bates-Diop",503,60,142,13,52,47,90,18,28,16,67,83,17,18,14,14,29,151
"328","Kelly Olynyk",5129,837,1708,287,791,550,917,376,482,234,933,1167,495,158,101,357,612,2337
"329","Kelly Oubre",5771,879,2074,288,895,591,1179,455,576,191,758,949,229,222,111,243,610,2501
"330","Kemba Walker",8338,1962,4496,731,1934,1231,2562,1047,1229,129,788,917,1362,278,80,558,348,5702
"331","Kenneth Faried",2485,460,829,8,32,452,797,231,339,348,517,865,93,72,76,115,257,1159
"332","Kenrich Williams",1079,107,279,52,156,55,123,13,19,55,164,219,83,45,19,36,95,279
"333","Kent Bazemore",5395,857,2088,296,840,561,1248,406,544,107,633,740,557,280,139,403,482,2416
"334","Kentavious Caldwell-Pope",7022,1035,2482,463,1287,572,1195,444,537,163,710,873,465,268,41,248,400,2977
"335","Kevin Durant",7097,1902,3631,427,1113,1475,2518,1143,1294,103,1371,1474,1123,174,302,570,405,5374
"336","Kevin Huerter",2048,275,657,136,353,139,304,41,56,60,185,245,214,65,25,109,155,727
"337","Kevin Knox",2158,338,914,125,364,213,550,162,226,61,274,335,82,43,24,114,175,963
"338","Kevin Love",4134,813,1879,335,866,478,1013,594,675,282,1169,1451,267,102,50,254,299,2555
"339","Kevin Seraphin",559,109,198,0,2,109,196,14,22,41,101,142,23,7,20,29,66,232
"340","Kevon Looney",2838,385,647,4,24,381,623,128,216,321,435,756,194,95,126,99,381,902
"341","Khem Birch",1221,159,277,0,1,159,276,100,144,149,221,370,72,33,50,41,128,418
"342","Khris Middleton",5375,1099,2420,325,881,774,1539,536,620,95,795,890,659,199,28,365,442,3059
"343","Klay Thompson",7807,1874,3957,738,1767,1136,2190,397,474,117,744,861,531,205,121,371,413,4883
"344","Kobi Simmons",643,80,189,11,39,69,150,25,25,14,36,50,68,18,5,44,61,196
"345","Kosta Koufos",3312,511,934,0,1,511,933,81,160,319,733,1052,170,98,98,137,386,1103
"346","Kris Dunn",4247,619,1485,98,303,521,1182,175,242,67,507,574,775,250,84,343,518,1511
"347","Kris Humphries",689,87,214,19,54,68,160,64,82,60,146,206,29,15,21,28,69,257
"348","Kristaps Porzingis",3717,833,1874,202,542,631,1332,416,527,173,618,791,154,83,244,211,385,2284
"349","Kyle Anderson",3259,381,714,28,91,353,623,141,210,132,515,647,330,169,97,152,226,931
"350","Kyle Korver",4661,662,1482,464,1083,198,399,162,187,25,488,513,279,90,60,183,343,1950
"351","Kyle Kuzma",4715,964,2126,287,856,677,1270,335,458,148,717,865,319,90,60,273,330,2550
"352","Kyle Lowry",4723,707,1683,395,1049,312,634,384,455,107,639,746,1101,176,50,365,358,2193
"353","Kyle O'Quinn",1758,293,520,5,29,288,491,115,148,150,439,589,214,45,123,131,260,706
"354","Kyle Singler",59,7,21,2,5,5,16,7,13,1,9,10,2,1,0,3,4,23
"355","Kyrie Irving",6670,1809,3748,517,1282,1292,2466,743,834,156,636,792,1188,251,75,492,446,4878
"356","LaMarcus Aldridge",7531,1871,3715,60,190,1811,3525,903,1082,669,1233,1902,485,132,285,353,498,4705
"357","Lance Stephenson",3334,541,1261,146,449,395,812,142,213,98,593,691,434,92,27,243,320,1370
"358","Lance Thomas",3104,277,708,110,288,167,420,114,140,97,337,434,106,68,26,89,302,778
"359","Landry Shamet",1802,240,557,167,396,73,161,75,93,21,113,134,117,37,10,45,155,722
"360","Langston Galloway",4103,561,1472,330,906,231,566,165,201,89,330,419,236,118,19,88,270,1617
"361","Larry Drew",70,7,24,3,9,4,15,0,0,3,0,3,10,0,0,3,6,17
"362","Larry Nance",4658,679,1253,45,146,634,1107,246,351,449,924,1373,392,270,117,204,513,1649
"363","Lauri Markkanen",3702,716,1657,265,733,451,924,310,361,153,825,978,154,76,73,168,225,2007
"364","Leandro Barbosa",963,172,392,35,98,137,294,40,45,15,89,104,81,31,8,48,82,419
"365","LeBron James",7757,2151,4019,384,1075,1767,2944,1024,1480,251,1562,1813,1847,280,148,847,364,5710
"366","London Perrantes",66,2,13,0,3,2,10,3,5,1,3,4,5,2,1,1,6,7
"367","Lonnie Walker",118,16,46,5,13,11,33,8,10,0,17,17,9,7,3,4,7,45
"368","Lonzo Ball",3203,388,1020,165,523,223,497,52,119,123,488,611,631,157,62,239,231,993
"369","Lorenzo Brown",212,23,71,6,28,17,43,3,3,5,26,31,28,12,5,16,22,55
"370","Lou Williams",6576,1494,3473,454,1255,1040,2218,1259,1433,106,516,622,1058,222,50,575,278,4701
"371","Luc Mbah a Moute",3412,365,741,108,289,257,452,126,187,68,295,363,96,154,61,116,230,964
"372","Lucas Nogueira",1506,152,236,8,31,144,205,63,95,100,231,331,64,75,132,62,186,375
"373","Luka Dončić",2318,506,1186,168,514,338,672,346,485,86,477,563,429,77,25,247,137,1526
"374","Luke Babbitt",1780,204,496,147,366,57,130,28,37,19,218,237,67,28,18,44,172,583
"375","Luke Kennard",1437,228,520,106,269,122,251,51,61,12,171,183,114,26,10,57,92,613
"376","Luke Kornet",1110,156,408,98,272,58,136,46,57,39,160,199,80,33,58,37,69,456
"377","Luol Deng",392,59,118,14,44,45,74,25,35,20,53,73,18,15,8,14,24,157
"378","Malachi Richardson",625,67,187,28,93,39,94,36,46,10,60,70,24,16,2,26,63,198
"379","Malcolm Brogdon",5250,912,1886,244,598,668,1288,325,363,135,522,657,674,171,38,270,370,2393
"380","Malcolm Delaney",2262,254,673,72,234,182,439,149,185,19,204,223,356,74,7,161,194,729
"381","Malcolm Miller",67,11,26,10,21,1,5,3,4,1,4,5,1,1,1,1,5,35
"382","Malik Beasley",2627,455,988,200,515,255,473,86,109,54,234,288,139,77,17,87,162,1196
"383","Malik Monk",2112,380,1011,192,573,188,438,122,140,24,179,203,208,57,28,135,166,1074
"384","Manu Ginobili",1299,201,463,64,192,137,271,110,131,19,123,142,163,43,16,105,126,576
"385","Marc Gasol",7375,1356,3063,312,861,1044,2202,751,922,218,1465,1683,992,205,286,515,573,3775
"386","Marcelo Huertas",237,25,68,4,19,21,49,9,17,2,22,24,52,10,2,19,16,63
"387","Marcin Gortat",5382,779,1420,0,2,779,1418,248,370,486,1247,1733,337,86,146,268,480,1806
"388","Marco Belinelli",5540,886,2069,398,1073,488,996,410,455,50,477,527,427,145,29,236,302,2580
"389","Marcus Derrickson",67,16,33,10,20,6,13,4,5,8,5,13,1,0,1,3,9,46
"390","Marcus Georges-Hunt",224,21,48,4,15,17,33,13,21,7,9,16,7,6,0,3,32,59
"391","Marcus Morris",6103,1060,2462,350,980,710,1482,415,512,196,917,1113,341,130,62,244,449,2885
"392","Marcus Smart",6213,697,1831,295,927,402,904,404,512,178,550,728,944,339,85,411,526,2093
"393","Marcus Thornton",575,84,210,28,80,56,130,23,27,22,54,76,41,19,3,25,48,219
"394","Mario Chalmers",1421,168,443,53,191,115,252,118,138,13,144,157,197,79,14,117,179,507
"395","Mario Hezonja",3823,581,1411,175,563,406,848,213,269,89,577,666,256,168,54,232,318,1550
"396","Markelle Fultz",680,110,266,4,15,106,251,31,58,37,76,113,112,29,9,42,74,255
"397","Markieff Morris",3238,534,1171,144,410,390,761,176,220,136,538,674,221,92,60,181,391,1388
"398","Marquese Chriss",2026,269,657,72,262,197,395,128,203,116,421,537,105,68,81,143,286,738
"399","Marreese Speights",1961,382,897,189,510,193,387,160,192,109,397,506,105,31,63,109,335,1113
"400","Marshall Plumlee",52,1,3,0,0,1,3,12,16,4,13,17,2,0,1,3,10,14
"401","MarShon Brooks",580,127,271,34,86,93,185,43,56,20,46,66,50,20,7,37,39,331
"402","Marvin Williams",6434,830,1919,390,1041,440,878,299,359,239,1038,1277,294,185,152,173,406,2349
"403","Mason Plumlee",5318,817,1433,2,17,815,1416,367,677,467,1062,1529,669,184,249,363,662,2003
"404","Matt Barnes",1777,185,473,87,263,98,210,70,89,70,314,384,195,48,26,107,185,527
"405","Matthew Dellavedova",3510,361,928,152,423,209,505,149,175,44,244,288,683,81,2,250,295,1023
"406","Maurice Harkless",4902,650,1309,150,432,500,877,168,256,248,524,772,215,200,166,171,480,1618
"407","Maurice Ndour",331,39,86,1,7,38,79,19,26,22,42,64,8,15,8,12,30,98
"408","Maxi Kleber",2708,326,695,117,346,209,349,102,133,161,402,563,121,62,125,84,257,871
"409","Meyers Leonard",2354,324,698,135,350,189,348,87,102,88,452,540,163,33,37,88,313,870
"410","Michael Beasley",2865,700,1366,55,146,645,1220,230,303,150,517,667,201,72,80,236,279,1685
"411","Michael Carter-Williams",2053,234,658,39,161,195,497,163,219,80,281,361,299,102,61,138,249,670
"412","Michael Kidd-Gilchrist",5378,735,1510,17,58,718,1452,364,488,328,785,1113,246,164,148,152,486,1851
"413","Mikal Bridges",2417,242,563,105,313,137,250,95,118,56,208,264,173,129,38,70,201,684
"414","Mike Conley",5007,1018,2297,350,922,668,1375,712,840,71,436,507,931,198,44,304,273,3098
"415","Mike Dunleavy",841,93,220,53,134,40,86,36,45,18,97,115,50,15,7,28,67,275
"416","Mike James",687,123,321,26,98,97,223,64,84,13,77,90,126,28,7,49,48,336
"417","Mike Miller",151,9,23,8,20,1,3,2,2,2,36,38,22,2,0,13,9,28
"418","Mike Muscala",3603,458,1010,197,533,261,477,176,211,189,525,714,222,83,106,145,307,1289
"419","Mike Scott",2996,461,1003,171,442,290,561,79,117,103,457,560,163,53,26,131,316,1172
"420","Miles Bridges",1696,237,511,65,200,172,311,58,77,67,256,323,95,55,49,50,111,597
"421","Miles Plumlee",1575,181,320,0,0,181,320,68,129,131,231,362,83,41,47,103,166,430
"422","Miloš Teodosić",1284,168,400,98,259,70,141,43,53,19,123,142,241,26,6,118,130,477
"423","Mindaugas Kuzminskas",1016,158,369,54,168,104,201,55,68,47,79,126,69,29,11,51,79,425
"424","Mirza Teletovic",1292,181,475,125,350,56,125,35,45,14,171,185,58,16,14,44,123,522
"425","Mohamed Bamba",766,117,243,21,70,96,173,37,63,64,169,233,39,13,64,43,102,292
"426","Monta Ellis",1998,247,557,43,135,204,422,93,128,19,185,204,236,78,27,135,149,630
"427","Monte Morris",1970,346,702,94,227,252,475,65,81,35,159,194,297,73,4,52,102,851
"428","Montrezl Harrell",4515,1119,1781,5,31,1114,1750,481,757,368,692,1060,300,127,204,244,524,2724
"429","Moritz Wagner",446,71,171,22,77,49,94,43,53,17,68,85,24,11,13,39,57,207
"430","Myke Henry",378,41,109,19,58,22,51,6,10,10,28,38,22,31,6,19,28,107
"431","Myles Turner",6496,1130,2288,172,468,958,1820,553,710,333,1204,1537,308,172,489,301,643,2985
"432","Naz Mitrou-Long",84,6,20,2,11,4,9,2,2,1,5,6,15,1,1,8,10,16
"433","Nemanja Bjelica",4349,606,1320,235,617,371,703,151,198,235,727,962,312,144,92,193,492,1598
"434","Nene Hilario",1956,381,636,3,11,378,625,184,304,149,309,458,110,84,53,111,286,949
"435","Nerlens Noel",2574,401,690,0,2,401,688,152,218,268,519,787,115,162,168,125,351,954
"436","Nick Collison",203,27,42,0,1,27,41,10,21,16,35,51,16,2,2,11,24,64
"437","Nick Young",1393,201,488,123,326,78,162,56,65,20,105,125,36,38,7,39,100,581
"438","Nicolas Batum",6952,916,2187,343,977,573,1210,428,503,174,1003,1177,1052,222,95,442,321,2603
"439","Nicolas Brussino",521,52,141,29,95,23,46,17,22,26,69,95,47,17,8,26,43,150
"440","Nicolas Laprovittola",174,20,47,10,27,10,20,9,9,1,9,10,28,4,1,19,19,59
"441","Nigel Hayes",122,11,33,4,16,7,17,1,3,4,18,22,6,2,3,2,8,27
"442","Nik Stauskas",3726,447,1126,242,647,205,479,200,243,43,374,417,308,75,43,205,218,1336
"443","Nikola Jokic",4481,998,1864,156,419,842,1445,454,541,407,1114,1521,817,151,116,381,426,2606
"444","Nikola Mirotic",3173,564,1309,264,735,300,574,211,265,120,669,789,155,97,94,142,236,1603
"445","Nikola Vucevic",3846,882,1871,87,279,795,1592,184,254,277,1025,1302,399,132,136,226,324,2035
"446","Noah Vonleh",3862,441,944,73,223,368,721,207,308,314,912,1226,194,95,95,183,396,1162
"447","Norman Powell",3556,570,1280,177,529,393,751,220,273,56,371,427,262,128,43,201,334,1537
"448","Norris Cole",125,16,52,3,13,13,39,8,10,0,11,11,14,8,0,7,18,43
"449","OG Anunoby",2833,346,750,140,399,206,351,75,124,102,279,381,102,98,36,100,270,907
"450","Okaro White",80,7,16,4,11,3,5,2,3,3,8,11,2,1,1,1,6,20
"451","Omari Johnson",75,9,21,4,12,5,9,0,0,4,7,11,7,2,0,3,6,22
"452","Omari Spellman",805,98,244,44,128,54,116,32,45,72,122,194,47,26,25,31,67,272
"453","Omer Asik",664,40,87,0,0,40,87,27,52,57,153,210,18,7,14,23,71,107
"454","Omri Casspi",1260,206,368,25,65,181,303,89,127,47,268,315,77,38,28,60,106,526
"455","Otto Porter",4115,744,1528,242,569,502,959,184,224,157,649,806,277,198,72,140,259,1914
"456","P.J. Tucker",5083,379,964,261,697,118,267,84,119,214,722,936,173,210,65,137,457,1103
"457","Pascal Siakam",4227,772,1443,108,346,664,1097,291,389,203,710,913,407,135,94,221,407,1943
"458","Pat Connaughton",2749,328,740,140,410,188,330,66,84,97,322,419,213,56,47,76,201,862
"459","Patrick Beverley",2471,242,596,136,342,106,254,110,140,92,341,433,332,86,48,110,299,730
"460","Patrick McCaw",1358,118,288,28,108,90,180,39,49,23,107,130,110,66,12,58,105,303
"461","Patrick Patterson",2131,188,485,112,308,76,177,59,76,74,266,340,88,64,36,55,133,547
"462","Patty Mills",4015,562,1345,313,818,249,527,193,221,50,286,336,474,104,21,199,257,1630
"463","Pau Gasol",2172,329,721,49,133,280,588,186,249,151,605,756,290,29,94,124,150,893
"464","Paul George",5732,1283,2954,536,1366,747,1588,791,951,177,898,1075,581,331,73,417,447,3893
"465","Paul Millsap",3038,524,1100,97,272,427,828,293,410,218,532,750,246,122,98,168,282,1438
"466","Paul Zipser",1667,169,455,70,209,99,246,50,65,28,228,256,82,35,31,83,164,458
"467","PJ Dozier",51,8,21,2,8,6,13,1,2,6,11,17,5,2,0,0,2,19
"468","Quincy Acy",2040,204,553,141,397,63,156,101,130,63,334,397,83,48,48,85,240,650
"469","Quincy Pondexter",488,43,107,9,40,34,67,48,59,16,57,73,33,19,3,24,48,143
"470","Quinn Cook",1799,326,691,127,304,199,387,42,51,32,207,239,205,32,4,82,151,821
"471","Rajon Rondo",3074,406,926,101,292,305,634,48,82,65,441,506,900,127,17,278,219,961
"472","Ramon Sessions",1203,142,380,29,88,113,292,135,175,17,94,111,206,41,5,76,72,448
"473","Rashad Vaughn",670,80,212,40,118,40,94,6,11,7,63,70,36,24,13,20,47,206
"474","Raul Neto",972,143,312,39,107,104,205,54,68,13,98,111,168,27,8,71,87,379
"475","Ray Spalding",148,25,47,0,3,25,44,4,12,15,33,48,5,9,8,9,23,54
"476","Raymond Felton",3444,500,1201,147,435,353,766,98,121,62,346,408,446,125,44,173,245,1245
"477","Reggie Bullock",4078,566,1268,301,747,265,521,117,141,62,329,391,253,105,28,122,201,1550
"478","Reggie Jackson",4914,971,2301,292,824,679,1477,434,506,95,360,455,852,117,18,361,424,2668
"479","Reggie Williams",79,8,23,5,11,3,12,6,7,2,4,6,4,3,0,0,2,27
"480","Richard Jefferson",1777,165,370,64,193,101,177,84,115,30,190,220,93,28,11,57,164,478
"481","Richaun Holmes",1930,357,606,4,31,353,575,165,231,172,370,542,121,62,108,77,291,883
"482","Ricky Rubio",4153,641,1557,175,527,466,1030,415,482,77,517,594,826,212,21,387,386,1872
"483","Robert Covington",3735,501,1198,288,775,213,423,184,225,83,543,626,202,211,119,173,364,1474
"484","Robin Lopez",5567,1028,1955,11,47,1017,1908,232,317,518,578,1096,293,43,248,294,384,2299
"485","Rodions Kurucs",1294,202,449,58,184,144,265,72,92,56,190,246,52,41,25,77,146,534
"486","Rodney Hood",5102,886,2088,325,876,561,1212,338,399,63,461,524,317,142,35,190,383,2435
"487","Rodney McGruder",3815,412,994,167,480,245,514,100,151,165,361,526,253,90,33,124,276,1091
"488","Rodney Purvis",290,35,107,13,52,22,55,13,15,1,26,27,17,3,3,10,26,96
"489","Rodney Stuckey",696,91,244,19,60,72,184,80,107,6,78,84,84,16,0,53,44,281
"490","Ron Baker",1394,106,296,35,132,71,164,53,75,18,121,139,169,66,15,79,125,300
"491","Rondae Hollis-Jefferson",4915,777,1753,37,170,740,1583,557,752,280,941,1221,417,191,119,305,429,2148
"492","Ronnie Price",134,4,24,3,17,1,7,3,4,3,8,11,18,11,1,3,14,14
"493","Roy Hibbert",682,80,147,0,0,80,147,61,75,54,98,152,21,8,46,32,100,221
"494","Royce O'Neale",2821,283,627,110,294,173,333,93,118,47,474,521,219,90,40,125,277,769
"495","Rudy Gay",3073,629,1283,111,302,518,981,232,292,139,622,761,255,100,72,192,257,1601
"496","Rudy Gobert",4393,752,1156,0,0,752,1156,536,821,474,1168,1642,241,110,316,237,384,2040
"497","Russell Westbrook",5544,1387,3160,216,737,1171,2423,713,1017,261,1350,1611,1604,289,53,706,445,3703
"498","Ryan Anderson",2047,228,549,140,379,88,170,84,109,112,273,385,79,28,22,56,151,680
"499","Ryan Arcidiacono",1961,187,418,81,217,106,201,89,102,27,192,219,269,65,4,63,171,544
"500","Ryan Broekhoff",453,57,126,38,93,19,33,15,19,8,55,63,22,6,4,16,35,167
"501","Ryan Kelly",110,8,28,4,10,4,18,5,6,1,17,18,8,4,5,4,5,25
"502","Salah Mejri",2033,231,386,12,40,219,346,94,159,218,467,685,84,64,154,100,328,568
"503","Sam Dekker",3090,451,944,89,309,362,635,103,170,191,415,606,160,100,37,98,201,1094
"504","Sasha Vujacic",408,42,136,23,74,19,62,17,24,12,47,59,52,13,2,16,38,124
"505","Sean Kilpatrick",2394,415,1029,151,452,264,577,268,314,27,340,367,203,58,11,173,151,1249
"506","Semi Ojeleye",1744,132,346,68,214,64,132,49,80,61,186,247,43,31,8,44,134,381
"507","Serge Ibaka",4103,843,1661,156,466,687,1195,229,295,234,845,1079,161,58,202,204,420,2071
"508","Seth Curry",3428,550,1168,250,573,300,595,129,152,52,247,299,255,115,19,153,223,1479
"509","Shabazz Muhammad",418,84,188,7,27,77,161,39,50,23,53,76,14,9,3,6,30,214
"510","Shabazz Napier",3030,465,1149,192,538,273,611,269,325,52,279,331,360,154,32,197,189,1391
"511","Shai Gilgeous-Alexander",2174,341,716,51,139,290,577,156,195,57,175,232,270,96,45,141,175,889
"512","Shake Milton",268,34,87,14,44,20,43,5,7,9,26,35,18,8,8,6,29,87
"513","Shane Larkin",775,84,219,31,86,53,133,32,37,15,77,92,98,29,2,33,58,231
"514","Shaquille Harrison",1814,243,550,30,115,213,435,110,161,42,241,283,194,115,37,82,166,626
"515","Shaun Livingston",2096,281,553,0,7,281,546,90,112,74,174,248,254,66,48,96,191,652
"516","Sheldon Mac",287,30,75,7,30,23,45,23,27,4,30,34,15,8,2,5,17,90
"517","Shelvin Mack",3816,511,1198,131,389,380,809,180,258,61,334,395,609,143,15,245,275,1333
"518","Sindarius Thornwell",1469,117,282,26,76,91,206,84,122,38,146,184,86,62,32,73,166,344
"519","Skal Labissiere",1416,231,507,24,64,207,443,104,135,108,223,331,83,30,55,84,161,590
"520","Solomon Hill",1065,79,219,36,122,43,97,26,38,43,126,169,77,30,11,40,102,220
"521","Spencer Dinwiddie",4220,690,1666,265,803,425,863,505,624,66,359,425,835,108,40,280,373,2150
"522","Stanley Johnson",4473,510,1365,174,603,336,762,198,262,103,555,658,305,211,52,229,404,1392
"523","Stephen Curry",6600,1735,3647,890,2100,845,1547,866,951,142,841,983,1195,314,50,584,463,5226
"524","Stephen Zimmerman",108,10,31,0,0,10,31,3,5,11,24,35,4,2,5,3,17,23
"525","Sterling Brown",1810,227,517,85,238,142,279,50,66,56,271,327,109,56,21,71,168,589
"526","Steven Adams",5156,929,1521,0,4,929,1517,306,578,775,670,1445,212,209,154,263,419,2164
"527","T.J. Leaf",981,163,319,26,73,137,246,29,47,72,135,207,33,14,23,22,80,381
"528","T.J. McConnell",3176,430,840,41,104,389,736,60,76,65,335,400,561,171,30,203,227,961
"529","T.J. Warren",3502,826,1674,97,270,729,1404,294,379,156,351,507,149,116,70,137,268,2043
"530","Taj Gibson",4412,729,1274,18,69,711,1205,276,362,366,676,1042,183,115,98,162,404,1752
"531","Tarik Black",536,75,127,1,11,74,116,29,63,63,100,163,13,21,30,35,107,180
"532","Taurean Waller-Prince",4997,791,1854,332,874,459,980,321,390,97,648,745,387,181,88,352,405,2235
"533","Terrance Ferguson",2694,255,600,146,410,109,190,46,61,52,136,188,91,64,26,58,314,702
"534","Terrence Ross",4705,842,1964,389,1050,453,914,217,257,55,504,559,261,186,73,187,307,2290
"535","Terry Rozier",5122,725,1877,329,918,396,959,239,308,135,775,910,594,194,51,195,293,2018
"536","Thabo Sefolosha",3011,363,784,107,282,256,502,113,151,91,463,554,167,191,48,113,197,946
"537","Thaddeus Young",7333,1226,2392,154,445,1072,1947,187,313,507,976,1483,478,371,101,323,504,2793
"538","Theo Pinson",211,25,73,12,46,13,27,19,22,4,32,36,21,6,0,18,15,81
"539","Thomas Bryant",1568,317,523,34,109,283,414,112,146,116,355,471,98,26,69,62,132,780
"540","Thon Maker",2772,322,765,108,331,214,434,153,226,156,385,541,114,69,130,94,351,905
"541","Tiago Splitter",76,14,31,2,6,12,25,9,11,8,14,22,4,1,1,6,8,39
"542","Tim Frazier",3483,347,837,94,285,253,552,162,213,93,363,456,777,133,18,234,342,950
"543","Tim Hardaway",6096,1165,2761,441,1304,724,1457,542,669,100,570,670,496,171,33,303,367,3313
"544","Tim Quarterman",80,13,29,5,13,8,16,0,3,4,10,14,11,2,3,11,6,31
"545","Timofey Mozgov",1463,221,421,4,19,217,402,86,108,136,226,362,54,21,44,105,172,532
"546","Timothe Luwawu-Cabarrot",1476,182,485,89,274,93,211,77,99,25,144,169,80,31,13,59,170,530
"547","Tobias Harris",5515,1173,2475,339,838,834,1637,445,523,127,955,1082,421,122,72,256,348,3130
"548","Tomas Satoransky",1643,201,384,47,101,154,283,75,96,72,161,233,286,52,15,83,131,524
"549","Tomáš Satoranský",2164,257,530,64,162,193,368,131,160,82,197,279,399,82,13,120,172,709
"550","Toney Douglas",394,43,117,7,42,36,75,24,29,13,48,61,56,18,5,21,50,117
"551","Tony Allen",2187,318,686,19,66,299,620,91,151,186,252,438,107,126,32,119,227,746
"552","Tony Parker",2074,391,851,23,88,368,763,146,202,21,157,178,402,49,8,143,105,951
"553","Tony Snell",3357,348,786,189,472,159,314,75,90,38,260,298,166,73,46,59,205,960
"554","Torrey Craig",1503,160,362,61,188,99,174,49,70,89,174,263,72,37,46,44,175,430
"555","Trae Young",2503,525,1256,156,482,369,774,343,414,64,237,301,653,72,15,308,140,1549
"556","Travis Wear",228,25,72,17,47,8,25,8,8,0,38,38,7,4,5,6,30,75
"557","Treveon Graham",1954,179,452,87,240,92,212,69,96,70,180,250,99,52,10,47,195,514
"558","Trevor Ariza",7391,888,2185,506,1451,382,734,299,379,137,986,1123,532,336,54,231,395,2581
"559","Trevor Booker",2912,482,934,33,111,449,823,140,203,260,629,889,220,103,49,186,271,1137
"560","Trey Burke",1910,429,932,94,264,335,668,140,181,41,129,170,329,57,11,92,101,1092
"561","Trey Lyles",2511,477,1045,134,418,343,627,182,259,99,494,593,178,60,57,129,204,1270
"562","Tristan Thompson",2270,333,615,0,0,333,615,111,185,299,491,790,119,44,33,95,191,777
"563","Troy Daniels",3565,530,1345,395,1007,135,338,117,141,47,253,300,120,72,14,128,306,1572
"564","Troy Williams",1176,168,374,43,144,125,230,50,77,49,142,191,52,57,22,60,131,429
"565","Ty Lawson",1732,237,522,34,118,203,404,173,217,44,135,179,334,74,6,129,119,681
"566","Tyler Cavanaugh",518,67,152,32,89,35,63,17,21,45,82,127,27,9,4,14,61,183
"567","Tyler Dorsey",1672,251,646,116,331,135,315,83,124,44,199,243,135,31,7,64,116,701
"568","Tyler Ennis",683,94,224,14,56,80,168,22,29,19,76,95,105,30,10,38,75,224
"569","Tyler Johnson",5759,883,2061,302,834,581,1227,396,510,118,596,714,564,198,105,248,421,2464
"570","Tyler Lydon",94,9,18,4,10,5,8,1,3,7,11,18,6,2,0,4,10,23
"571","Tyler Ulis",2781,398,988,63,225,335,763,139,172,44,179,223,537,118,12,204,193,998
"572","Tyler Zeller",1202,203,364,10,29,193,335,71,97,121,208,329,51,16,38,51,146,487
"573","Tyreke Evans",3009,623,1469,191,502,432,967,279,369,77,389,466,435,115,35,235,213,1716
"574","Tyrone Wallace",628,92,217,4,19,88,198,30,57,20,81,101,42,21,7,36,83,218
"575","Tyson Chandler",3324,335,514,0,1,335,513,200,304,379,885,1264,120,70,74,166,342,870
"576","Tyus Jones",3801,410,955,111,328,299,627,162,193,49,284,333,715,224,16,144,238,1093
"577","Udonis Haslem",276,25,71,1,23,24,48,13,21,14,59,73,13,6,3,13,34,64
"578","Victor Oladipo",5921,1301,2862,362,1002,939,1860,513,663,107,776,883,685,315,89,420,402,3477
"579","Vince Carter",4155,503,1241,292,777,211,464,163,218,85,484,569,289,146,89,134,400,1461
"580","Wade Baldwin",579,60,169,9,36,51,133,45,58,14,55,69,78,21,10,57,63,174
"581","Walt Lemon",167,38,87,2,5,36,82,8,11,4,23,27,30,11,1,10,14,86
"582","Wayne Ellington",4838,700,1712,514,1345,186,367,143,170,55,402,457,221,142,18,122,256,2057
"583","Wayne Selden",2367,337,810,111,324,226,486,125,173,54,198,252,188,57,19,145,208,910
"584","Wendell Carter",1110,180,371,6,32,174,339,89,112,87,220,307,78,26,58,65,152,455
"585","Wesley Iwundu",2253,206,492,38,125,168,367,118,150,73,248,321,130,61,34,74,204,568
"586","Wesley Johnson",2020,195,496,85,253,110,243,56,77,41,247,288,84,90,74,73,209,531
"587","Wesley Matthews",4222,562,1395,303,805,259,590,215,264,60,308,368,332,130,33,174,300,1642
"588","Will Barton",3872,650,1488,223,618,427,870,239,300,102,506,608,455,100,74,214,250,1762
"589","Willie Cauley-Stein",4257,800,1514,4,14,796,1500,293,501,312,876,1188,366,173,118,193,412,1897
"590","Willie Reed",428,81,121,1,2,80,119,32,55,35,86,121,10,9,22,19,56,195
"591","Willy Hernangomez",1819,337,629,9,27,328,602,150,215,231,454,685,129,59,52,135,214,833
"592","Wilson Chandler",5720,828,1843,257,730,571,1113,247,333,253,820,1073,382,119,90,252,451,2160
"593","Xavier Rathan-Mayes",118,12,42,1,14,11,28,4,9,0,5,5,18,6,3,11,18,29
"594","Yogi Ferrell",4546,624,1476,256,684,368,792,216,259,59,410,469,510,142,22,188,307,1720
"595","Yuta Watanabe",174,15,51,2,16,13,35,7,10,4,27,31,8,4,1,6,11,39
"596","Zach Collins",2401,304,689,75,234,229,455,121,168,154,391,545,123,42,97,135,307,804
"597","Zach LaVine",2827,666,1490,162,444,504,1046,399,482,49,339,388,355,84,30,258,195,1893
"598","Zach Randolph",1508,361,763,51,147,310,616,84,107,97,300,397,127,42,10,116,119,857
"599","Zaza Pachulia",3118,398,764,0,7,398,757,270,343,328,668,996,332,128,67,216,439,1066
"600","Zhaire Smith",111,14,34,6,16,8,18,6,8,3,10,13,10,2,2,6,8,40
"601","Zhou Qi",124,6,32,2,19,4,13,8,12,6,16,22,2,2,14,10,14,22
